22222222222
23G333G3G32
23G33333G32
23333M33332
23333333332
233G3333332
23G33933G32
23G33P33G32
22222222222