22222222222
2333HH33332
23333333332
23333M33332
2HH33333HH2
23333333332
23333932332
2HH33P33HH2
22222222222