2222222222222222222222
2333333333333333333332
2333332222333333222332
2333332333333333322332
2333332333333333322332
2333332333333333322332
2333332333333333322332
2333332222222222222332
2333333333333333333332
2333333332333333333332
2333333332333333333332
2333332222222222222332
2333333333333333333332
2333332333333333332332
2333332333333333332332
2333332333333333332332
2222222222333333332222
2333333332333333333332
2333333332333333333332
2333332222222222222332
2333333333333333333332
2333332333333333332332
2333332333333333332332
2333332333333333332332
2222222222222222222222
