222222222222222222222222222222
2M33333333333322333333333333G2
233322222223332233322222222332
23332G333323333333323333G32332
233322232223332233322232222332
233333333333332233333333333332
233322222223332233322222222332
2G33233333233G3333G233333233G2
233323333323332233323333323332
233333333333332233333333333332
222222332222222222222233222222
233333333333333333333333333332
233322222223332233322222222332
23G323333323332233323333323G32
233333333333332233333333333332
222222222222333333222222222222
233333333333333333333333333332
2G33333333333333333333333333G2
233333333333333333333333333332
222222222222233932222222222222
23333333333333P333333333333332
222222222222222222222222222222