111111111111111
13H333IPI333H31
13U3U3U3U3U3U31
1333H33333H3331
13U3U31113U3U31
133333191333331
13I3I31313I3I31
13H3333E3333H31
13I3I33333I3I31
133333333333331
13U3U33H33U3U31
13H333333333H31
13U3U3M333U3U31
133H3333333H331
111111111111111