22222222222
23333333332
23333333332
23333M33332
23333333332
233GG333332
2GGGG933332
2GGGGP33332
22222222222