22222222222222222222
2333H3333333333H3332
233OOOO333333IIII332
233OOOO333P33IIII332
23333333333333333332
2H3OOOO333333IIII3H2
233OOOO333333IIII332
2333333333T333333332
23311111333311111332
2H3333313393133333H2
233UU33133E3133OO332
233UU3333333333OO332
23333333333333333332
2H3OO3333H33H33OO3H2
233OO3333333333OO332
22222222222222222222