2222222222
2333333332
2333333332
2333333332
2333333332
2222332222
LLLLLLLLLL
LLLLLLLLLL
LLLLLLLLLL
LLLLLLLLLL
LLLLLLLLLL
LLLLLLLLLL
LLLLLLLLLL
LLLLLLLLLL
LLLLLLLLLL
LLLLLLLLLL