11111111111111111111111111111111111
1LLLLLLLLLLLLLLLLLLLLLLLLLLLLLLLLL1
1LLLLLLLLLLLLLLLLLLLLLLLLLLLLLLLLL1
1LLLLLLLLLLL00000000000LLLLLLLLLLL1
1LLLLLLLLLLL00A00000000LLLLLLLLLLL1
1LLLLLLLLLLL00000900000LLLLLLLLLLL1
1LLLLLLLLLLL00000000000LLLLLLLLLLL1
1LLLLLLLLLLL00000000000LLLLLLLLLLL1
1LLLLLLLLLLLLLL00000LLLLLLLLLLLLLL1
1LLLLLLLLLLLLLL00GK0LLLLLLLLLLLLLL1
1LLLLLLLLLLLLLL0G000LLLLLLLLLLLLLL1
11111111111111100000111111111111111
1BBBBBB000000000000000000000BBBBBB1
1BBBBBB000000J00H0000T000000BBBBBB1
1BBBBBB000000000000000000000BBBBBB1
1BBBBBB000000000M00000000000BBBBBB1
1BBBBBB000000000000000000000BBBBBB1
1BBBBBB000000000000000000000BBBBBB1
1BBBBBB000000000000000000000BBBBBB1
22222222222222223332222222222222222
23333333333333G33333M33333333333332
23222222222222223332222222222222332
23333333333333333333333333333332332
23222222322222223332222222222322332
23233332333333333333333333332333332
23232322222222222222222222222322332
23233333333333333333333333333322332
23222222222222222222222222223322332
23333333333333333333333333333322332
232222222222222222222222222223LL332
22222222222222222222222222222222222
