22222222222
23333333332
23333333332
23333M33332
23333333332
233HH333332
2HHHH933332
2HHHHP33332
22222222222