2222222222222222
23H3333P33333H32
23OOOO333IIII332
2H333333333333H2
23OOOO333IIII332
2333333T33333332
2111113331111112
2H33313931333H32
23UU313E313OO332
2333333H33333332
2H3OO33H33OO3H32
2222222222222222