11111111111111111111
1E3333U33333O3333H31
131113I3111333111331
131913331H13331H1331
131P13U31313O3131331
13333333333333333331
13H333H3I3H3U3H3O331
131313O31313U3131331
131H13331H13331H1331
131113I31113331113J1
11111111111111111111