111111111111111111111111
1E333333333U33333O3333H1
13311111333I333333331131
133139313333333333331H31
13313P3133U33333O3331331
133111113333333333331131
133333333333333333333331
133333333333333333333331
13H33333H33I33H33U33H331
13311333133O331333331131
1331H3331333331333331H31
133113331333331333331131
133333333333333333333331
133333333333333333333331
133O3333I333333U3333O331
133333333333333333333331
13333333333J333333333331
13H333333333333333333H31
111111111111111111111111