2222222222222222222222
2333333333333333333332
233G332222333333222G32
2333332333333333322332
23333323333M3333322332
2333332333333333322332
2G33332333333333322G32
2333332222222222222332
2333333333333333333332
2333G3333233333G333332
2333333332333333333332
2333332222222222222332
23333333333G3333333332
2333332333333333332332
23G3332333333333332332
2333332333333333332332
2222222222333333332222
2333333332333333333332
2G33333332333333G33332
2333332222222222222332
2333333333333333333332
2333332333333333332332
2333332333333333332332
23333323339J3333332332
2222222222222222222222